...###..##.
..#..###..#
.#........#
#.........#
#...@..#..#
#.#..###..#
#.#..#....#
#...#..#.##
.#......##.
.#.....##..
.#######...