###########
#@........#
#########.#
#.........#
#.#########
#.........#
#########.#
#.........#
#.#########
#.........#
###########